w1 w1 w1 w1 w1 w1 w1 w1 w1 w1 w1 w1 w1 w1 w1 w1 w1 w1 w1 w1 w1 w1 w1 w1 w1 w1 w1 w1 w1 w1 w1 w1 w1 w1 w1 w1 w1 w1 w1 w1 b
w1 w1 w1 w1 w1 w1 w1 w1 w1 w1 w1 w1 w1 w1 w1 w1 w1 w1 w1 w1 w1 w1 w1 w1 w1 w1 w1 w1 w1 w1 w1 w1 w1 w1 w1 w1 w1 w1 w1 w1 b
w1 w1 w1 w1 w1 w1 w1 w1 w1 w1 w1 w1 w1 w1 w1 w1 w1 w1 w1 w1 w1 w1 w1 w1 w1 w1 w1 w1 w1 w1 w1 w1 w1 w1 w1 w1 w1 w1 w1 w1 b
w1 w1 w1 w1 w1 w1 w1 w1 w1 w1 w1 w1 w1 w1 w1 w1 w1 w1 w1 w1 w1 w1 w1 w1 w1 w1 w1 w1 w1 w1 w1 w1 w1 w1 w1 w1 w1 w1 w1 w1 b
w1 w1 w1 w1 w1 0  1  1  1  1  1  1  1  1  1  1  1  1  1  1  1  1  1  1  1  1  1  1  1  1  1  1  1  1  2  w1 w1 w1 w1 w1 b
w1 w1 w1 w1 w1 3  4  4  4  4  4  4  4  4  4  4  4  4  4  4  4  4  4  4  4  4  4  4  4  4  4  4  4  4  5  w1 w1 w1 w1 w1 b
w1 w1 w1 w1 w1 3  4  4  4  4  4  4  4  4  4  4  4  4  4  4  4  4  4  4  4  4  4  4  4  4  4  4  4  4  5  w1 w1 w1 w1 w1 b
w1 w1 w1 w1 w1 3  4  4  4  4  4  4  4  4  4  4  4  4  4  4  4  4  4  4  4  4  4  4  4  4  4  4  4  4  5  w1 w1 w1 w1 w1 b
w1 w1 w1 w1 w1 3  4  4  4  4  4  4  4  4  4  4  4  4  4  4  4  4  4  4  4  4  4  4  4  4  4  4  4  4  5  w1 w1 w1 w1 w1 b
w1 w1 w1 w1 w1 3  4  4  4  4  4  4  4  4  4  4  4  4  4  4  4  4  4  4  4  4  4  4  4  4  4  4  4  4  5  w1 w1 w1 w1 w1 b
w1 w1 w1 w1 w1 3  4  4  4  4  4  4  4  4  4  4  4  4  4  4  4  4  4  4  4  4  4  4  4  4  4  4  4  4  5  w1 w1 w1 w1 w1 b
w1 w1 w1 w1 w1 3  4  4  4  4  4  4  4  4  4  4  4  4  4  4  4  4  4  4  4  4  4  4  4  4  4  4  4  4  5  w1 w1 w1 w1 w1 b
w1 w1 w1 w1 w1 3  4  4  4  4  4  4  4  4  4  4  4  4  4  4  4  4  4  4  4  4  4  4  4  4  4  4  4  4  5  w1 w1 w1 w1 w1 b
w1 w1 w1 w1 w1 3  4  4  4  4  4  4  4  4  4  4  4  4  4  4  4  4  4  4  4  4  4  4  4  4  4  4  4  4  5  w1 w1 w1 w1 w1 b
w1 w1 w1 w1 w1 3  4  4  4  4  4  4  4  4  4  4  4  4  4  4  4  4  4  4  4  4  4  4  4  4  4  4  4  4  5  w1 w1 w1 w1 w1 b
w1 w1 w1 w1 w1 3  4  4  4  4  4  4  4  4  4  4  4  4  4  4  4  4  4  4  4  4  4  4  4  4  4  4  4  4  5  w1 w1 w1 w1 w1 b
w1 w1 w1 w1 w1 3  4  4  4  4  4  4  4  4  4  4  4  4  4  4  4  4  4  4  4  4  4  4  4  4  4  4  4  4  5  w1 w1 w1 w1 w1 b
w1 w1 w1 w1 w1 3  4  4  4  4  4  4  4  4  4  4  4  4  4  4  4  4  4  4  4  4  4  4  4  4  4  4  4  4  5  w1 w1 w1 w1 w1 b
w1 w1 w1 w1 w1 3  4  4  4  4  4  4  4  4  4  4  4  4  4  4  4  4  4  4  4  4  4  4  4  4  4  4  4  4  5  w1 w1 w1 w1 w1 b
w1 w1 w1 w1 w1 6  7  7  7  7  7  7  7  7  7  7  7  7  7  7  7  7  7  7  7  7  7  7  7  7  7  7  7  7  8  w1 w1 w1 w1 w1 b
w1 w1 w1 w1 w1 w1 w1 w1 w1 w1 w1 w1 w1 w1 w1 w1 w1 w1 w1 w1 w1 w1 w1 w1 w1 w1 w1 w1 w1 w1 w1 w1 w1 w1 w1 w1 w1 w1 w1 w1 b
w1 w1 w1 w1 w1 w1 w1 w1 w1 w1 w1 w1 w1 w1 w1 w1 w1 w1 w1 w1 w1 w1 w1 w1 w1 w1 w1 w1 w1 w1 w1 w1 w1 w1 w1 w1 w1 w1 w1 w1 b
w1 w1 w1 w1 w1 w1 w1 w1 w1 w1 0  1  1  1  2  w1 w1 w1 w1 w1 w1 w1 w1 w1 w1 0  1  1  1  2  w1 w1 w1 w1 w1 w1 w1 w1 w1 w1 b
w1 w1 w1 w1 w1 w1 w1 w1 w1 w1 3  4  4  4  5  w1 w1 w1 w1 w1 w1 w1 w1 w1 w1 3  4  4  4  5  w1 w1 w1 w1 w1 w1 w1 w1 w1 w1 b
w1 w1 w1 w1 w1 w1 w1 w1 w1 w1 3  4  4  4  5  w1 w1 w1 w1 w1 w1 w1 w1 w1 w1 3  4  4  4  5  w1 w1 w1 w1 w1 w1 w1 w1 w1 w1 b
w1 w1 w1 w1 w1 w1 w1 w1 w1 w1 3  4  4  4  5  w1 w1 w1 w1 w1 w1 w1 w1 w1 w1 3  4  4  4  5  w1 w1 w1 w1 w1 w1 w1 w1 w1 w1 b
w1 w1 w1 w1 w1 w1 w1 w1 w1 w1 6  7  7  7  8  w1 w1 w1 w1 w1 w1 w1 w1 w1 w1 6  7  7  7  8  w1 w1 w1 w1 w1 w1 w1 w1 w1 w1 b
w1 w1 w1 w1 w1 w1 w1 w1 w1 w1 w1 w1 w1 w1 w1 w1 w1 w1 w1 w1 w1 w1 w1 w1 w1 w1 w1 w1 w1 w1 w1 w1 w1 w1 w1 w1 w1 w1 w1 w1 b
w1 w1 w1 w1 w1 w1 w1 w1 w1 w1 w1 w1 w1 w1 w1 w1 w1 w1 w1 w1 w1 w1 w1 w1 w1 w1 w1 w1 w1 w1 w1 w1 w1 w1 w1 w1 w1 w1 w1 w1 b
w1 w1 w1 w1 w1 w1 w1 w1 w1 w1 w1 w1 0  1  1  1  1  1  1  1  1  1  1  1  1  1  1  2  w1 w1 w1 w1 w1 w1 w1 w1 w1 w1 w1 w1 b
w1 w1 w1 w1 w1 w1 w1 w1 w1 w1 w1 w1 3  4  4  4  4  4  4  4  4  4  4  4  4  4  4  5  w1 w1 w1 w1 w1 w1 w1 w1 w1 w1 w1 w1 b
w1 w1 w1 w1 w1 w1 w1 w1 w1 w1 w1 w1 3  4  4  4  4  4  4  4  4  4  4  4  4  4  4  5  w1 w1 w1 w1 w1 w1 w1 w1 w1 w1 w1 w1 b
w1 w1 w1 w1 w1 w1 w1 w1 w1 w1 w1 w1 3  4  4  4  4  4  4  4  4  4  4  4  4  4  4  5  w1 w1 w1 w1 w1 w1 w1 w1 w1 w1 w1 w1 b
w1 w1 w1 w1 w1 w1 w1 w1 w1 w1 w1 w1 3  4  4  4  4  4  4  4  4  4  4  4  4  4  4  5  w1 w1 w1 w1 w1 w1 w1 w1 w1 w1 w1 w1 b
w1 w1 w1 w1 w1 w1 w1 w1 w1 w1 w1 w1 3  4  4  4  4  4  4  4  4  4  4  4  4  4  4  5  w1 w1 w1 w1 w1 w1 w1 w1 w1 w1 w1 w1 b
w1 w1 w1 w1 w1 w1 w1 w1 w1 w1 w1 w1 3  4  4  4  4  4  4  4  4  4  4  4  4  4  4  5  w1 w1 w1 w1 w1 w1 w1 w1 w1 w1 w1 w1 b
w1 w1 w1 w1 w1 w1 w1 w1 w1 w1 w1 w1 6  7  7  7  7  7  7  7  7  7  7  7  7  7  7  8  w1 w1 w1 w1 w1 w1 w1 w1 w1 w1 w1 w1 b
w1 w1 w1 w1 w1 w1 w1 w1 w1 w1 w1 w1 w1 w1 w1 w1 w1 w1 w1 w1 w1 w1 w1 w1 w1 w1 w1 w1 w1 w1 w1 w1 w1 w1 w1 w1 w1 w1 w1 w1 b
w1 w1 w1 w1 w1 w1 w1 w1 w1 w1 w1 w1 w1 w1 w1 w1 w1 w1 w1 w1 w1 w1 w1 w1 w1 w1 w1 w1 w1 w1 w1 w1 w1 w1 w1 w1 w1 w1 w1 w1 b
w1 w1 w1 w1 w1 w1 w1 w1 w1 w1 w1 w1 w1 w1 w1 w1 w1 w1 w1 w1 w1 w1 w1 w1 w1 w1 w1 w1 w1 w1 w1 w1 w1 w1 w1 w1 w1 w1 w1 w1 b
