w w w w w w w w w w w w w w w w w w w w w w w w w w w w w w w w w w w w w w w w
w w w w w w w w w w w w w w w w w w w w w w w w w w w w w w w w w w w w w w w w
w w w w w w w w w w w w w w w w w w w w w w w w w w w w w w w w w w w w w w w w
w w w w 0 1 1 1 1 1 1 1 1 1 1 1 1 1 1 1 1 1 1 1 1 1 1 1 1 1 1 1 1 1 1 2 w w w w
w w w w 3 4 4 4 4 4 4 4 4 4 4 4 4 4 4 4 4 4 4 4 4 4 4 4 4 4 4 4 4 4 4 5 w w w w
w w w w 3 4 4 4 4 4 4 4 4 4 4 4 4 4 4 4 4 4 4 4 4 4 4 4 4 4 4 4 4 4 4 5 w w w w
w w w w 3 4 4 4 4 4 4 4 4 4 4 4 4 4 4 4 4 4 4 4 4 4 4 4 4 4 4 4 4 4 4 5 w w w w
w w w w 3 4 4 4 4 4 4 4 4 4 4 4 4 4 4 4 4 4 4 4 4 4 4 4 4 4 4 4 4 4 4 5 w w w w
w w w w 3 4 4 4 4 4 4 4 4 4 4 4 4 4 4 4 4 4 4 4 4 4 4 4 4 4 4 4 4 4 4 5 w w w w
w w w w 3 4 4 4 4 4 4 4 4 4 4 4 4 4 4 4 4 4 4 4 4 4 4 4 4 4 4 4 4 4 4 5 w w w w
w w w w 3 4 4 4 4 4 4 4 4 4 4 4 4 4 4 4 4 4 4 4 4 4 4 4 4 4 4 4 4 4 4 5 w w w w
w w w w 3 4 4 4 4 4 4 4 4 4 4 4 4 4 4 4 4 4 4 4 4 4 4 4 4 4 4 4 4 4 4 5 w w w w
w w w w 3 4 4 4 4 4 4 4 4 4 4 4 4 4 4 4 4 4 4 4 4 4 4 4 4 4 4 4 4 4 4 5 w w w w
w w w w 3 4 4 4 4 4 4 4 4 4 4 4 4 4 4 4 4 4 4 4 4 4 4 4 4 4 4 4 4 4 4 5 w w w w
w w w w 3 4 4 4 4 4 4 4 4 4 4 4 4 4 4 4 4 4 4 4 4 4 4 4 4 4 4 4 4 4 4 5 w w w w
w w w w 3 4 4 4 4 4 4 4 4 4 4 4 4 4 4 4 4 4 4 4 4 4 4 4 4 4 4 4 4 4 4 5 w w w w
w w w w 3 4 4 4 4 4 4 4 4 4 4 4 4 4 4 4 4 4 4 4 4 4 4 4 4 4 4 4 4 4 4 5 w w w w
w w w w 3 4 4 4 4 4 4 4 4 4 4 4 4 4 4 4 4 4 4 4 4 4 4 4 4 4 4 4 4 4 4 5 w w w w
w w w w 3 4 4 4 4 4 w w w w w w w w w w w w w w 4 4 4 4 4 4 4 4 4 4 4 5 w w w w
w w w w 3 4 4 4 4 4 w w w w w w w w w w w w w w 4 4 4 4 4 4 4 4 4 4 4 5 w w w w
w w w w 3 4 4 4 4 4 w w w w w w w w w w w w w w 4 4 4 4 4 4 4 4 4 4 4 5 w w w w
w w w w 3 4 4 4 4 4 w w w w w w w w w w w w w w 4 4 4 4 4 4 4 4 4 4 4 5 w w w w
w w w w 3 4 4 4 4 4 w w w w w w w w w w w w w w 4 4 4 4 4 4 4 4 4 4 4 5 w w w w
w w w w 3 4 4 4 4 4 w w w w w w w w w w w w w w 4 4 4 4 4 4 4 4 4 4 4 5 w w w w
w w w w 3 4 4 4 4 4 w w w w w w w w w w w w w w 4 4 4 4 4 4 4 4 4 4 4 5 w w w w
w w w w 3 4 4 4 4 4 w w w w w w w w w w w w w w 4 4 4 4 4 4 4 4 4 4 4 5 w w w w
w w w w 3 4 4 4 4 4 w w w w w w w w w w w w w w 4 4 4 4 4 4 4 4 4 4 4 5 w w w w
w w w w 3 4 4 4 4 4 w w w w w w w w w w w w w w 4 4 4 4 4 4 4 4 4 4 4 5 w w w w
w w w w 3 4 4 4 4 4 w w w w w w w w w w w w w w 4 4 4 4 4 4 4 4 4 4 4 5 w w w w
w w w w 3 4 4 4 4 4 w w w w w w w w w w w w w w 4 4 4 4 4 4 4 4 4 4 4 5 w w w w
w w w w 3 4 4 4 4 4 w w w w w w w w w w w w w w 4 4 4 4 4 4 4 4 4 4 4 5 w w w w
w w w w 3 4 4 4 4 4 w w w w w w w w w w w w w w 4 4 4 4 4 4 4 4 4 4 4 5 w w w w
w w w w 3 4 4 4 4 4 4 4 4 4 4 4 4 4 4 4 4 4 4 4 4 4 4 4 4 4 4 4 4 4 4 5 w w w w
w w w w 3 4 4 4 4 4 4 4 4 4 4 4 4 4 4 4 4 4 4 4 4 4 4 4 4 4 4 4 4 4 4 5 w w w w
w w w w 3 4 4 4 4 4 4 4 4 4 4 4 4 4 4 4 4 4 4 4 4 4 4 4 4 4 4 4 4 4 4 5 w w w w
w w w w 3 4 4 4 4 4 4 4 4 4 4 4 4 4 4 4 4 4 4 4 4 4 4 4 4 4 4 4 4 4 4 5 w w w w
w w w w 6 7 7 7 7 7 7 7 7 7 7 7 7 7 7 7 7 7 7 7 7 7 7 7 7 7 7 7 7 7 7 8 w w w w
w w w w w w w w w w w w w w w w w w w w w w w w w w w w w w w w w w w w w w w w
w w w w w w w w w w w w w w w w w w w w w w w w w w w w w w w w w w w w w w w w
w w w w w w w w w w w w w w w w w w w w w w w w w w w w w w w w w w w w w w w w