b  b  b  b  b  b  b  b  b  b  b  b  b  b  b  b  b  b  b  b  b  b  b  b  b  b  b  b  b  b  b  b  b  b  b  b  b  b  b  b 
b  b  b  b  b  b  b  b  b  b  b  b  b  b  b  b  b  b  b  b  b  b  b  b  b  b  b  b  b  b  b  b  b  b  b  b  b  b  b  b 
b  b  b  b  b  b  b  b  b  b  b  b  b  b  b  b  b  b  b  b  b  b  b  b  b  b  b  b  b  b  b  b  b  b  b  b  b  b  b  b 
b  b  b  b  b  b  b  b  b  b  b  b  b  b  b  b  b  b  b  b  b  b  b  b  b  b  b  b  b  b  b  b  b  b  b  b  b  b  b  b 
b  b  b  b  b  b  b  b  b  b  b  b  b  b  b  b  b  b  b  b  b  b  b  b  b  b  b  b  b  b  b  b  b  b  b  b  b  b  b  b 
b  b  b  b  b  b  b  b  b  b  b  b  b  b  b  b  b  b  b  b  b  b  b  b  b  b  b  b  b  b  b  b  b  b  b  b  b  b  b  b 
b  b  b  b  b  b  b  b  b  b  b  b  b  b  b  b  b  b  b  b  b  b  b  b  b  b  b  b  b  b  b  b  b  b  b  b  b  b  b  b 
b  b  b  b  b  b  b  b  b  b  b  b  b  b  b  b  b  b  b  b  b  b  b  b  b  b  b  b  b  b  b  b  b  b  b  b  b  b  b  b 
b  b  b  b  b  b  b  b  b  b  b  b  b  b  b  b  b  b  b  b  b  b  b  b  b  b  b  b  b  b  b  b  b  b  b  b  b  b  b  b 
b  b  b  b  b  b  b  b  b  b  b  b  b  b  b  b  b  b  b  b1 b1 b  b  b  b  b  b  b  b  b  b  b  b  b  b  b  b  b  b  b 
b  b  b  b  b  b  b  b  b  b  b  b  b  b  b  b  b  b  b  b2 b2 b  b  b  b  b  b  b  b  b  b  b  b  b  b  b  b  b  b  b 
b  b  b  b  b  b  b  b  b  b  b  b  b  b  b  b  b  b  b  b2 b2 b  b  b  b  b  b  b  b  b  b  b  b  b  b  b  b  b  b  b 
b  b  b  b  b  b  b  b  b  b  b  b  b  b  b  b  b  b  b  b2 b2 b  b  b  b  b  b  b  b  b  b  b  b  b  b  b  b  b  b  b 
b  b  b  b  b  b  b  b  b  b  b  b  b  b  b  b  b  b  b  b2 b2 b  b  b  b  b  b  b  b  b  b  b  b  b  b  b  b  b  b  b 
b  b  b  b  b  b  b  b  b  b  y1 o1 y1 o1 y1 o1 y1 o1 y1 b3 b3 o1 y1 o1 y1 o1 y1 o1 y1 o1  b  b  b  b  b  b  b  b  b  b 
b  b  b  b  b  b  b  b  b  b  o1 b  b  b  b  b  b  b  b  b  b  b  b  b  b  b  b  b  b  y1  b  b  b  b  b  b  b  b  b  b         
b  b  b  b  b  b  b  b  b  b  y1 b  b  b  p2 b  b  b  p2 b  b  p2 p2 p2 b  b  b  b  b  o1  b  b  b  b  b  b  b  b  b  b 
b  b  b  b  b  b  b  b  b  b  o1 b  b  b  p2 b  b  b  p2 b  b  b  p2 b  b  b  b  b  b  y1 b  b  b  b  b  b  b  b  b  b 
b  b  b  b  b  b  b  b  b  b  y1 b  b  b  p2 b  b  b  p2 b  b  b  p2 b  b  b  b  b  b  o1 b  b  b  b  b  b  b  b  b  b 
b  b  b  b  b  b  b  b  b  b  o1 b  b  b  p2 p2 p2 b  p2 b  b  b  p2 b  b  b  b  b  b  y1 b  b  b  b  b  b  b  b  b  b 
b  b  b  b  b  b  b  b  b  b  y1 b  b  b  b  b  b  b  b  b  b  b  b  b  b  b  b  b  b  o1 b  b  b  b  b  b  b  b  b  b 
b  b  b  b  b  b  b  b  b  b  o1 b  b  p2 p2 p2 b  p2 p2 p2 b  p2 p2 p2 b  p2 p2 p2 b  y1 b  b  b  b  b  b  b  b  b  b 
b  b  b  b  c  b  s1 s2 s2 s2 s3 b  b  b  b  p2 b  p2 b  p2 b  p2 b  b  b  p2 b  p2 b  s1 s2 s2 s2 s3 b  c  b  b  b  b 
b  b  b  b  b  b  b  b  b  b  y1 b  b  b  p2 p2 b  p2 b  p2 b  p2 p2 p2 b  p2 b  p2 b  o1 b  b  b  b  b  b  b  b  b  b         
b  b  b  b  b  b  b  b  b  b  o1 b  b  b  b  p2 b  p2 b  p2 b  b  b  p2 b  p2 b  p2 b  y1 b  b  b  b  b  b  b  b  b  b 
b  b  b  b  b  b  b  b  b  b  y1 b  b  p2 p2 p2 b  p2 p2 p2 b  p2 p2 p2 b  p2 p2 p2 b  o1 b  b  b  b  b  b  b  b  b  b 
b  b  b  b  b  b  b  b  b  b  o1 b  b  b  b  b  b  b  b  b  b  b  b  b  b  b  b  b  b  y1 b  b  b  b  b  b  b  b  b  b
b  b  b  b  b  b  b  b  b  b  y1 b  b  a1 a2 t1 t2 a1 a2 t1 t2 a1 a2 t1 t2 a1 a2 b  b  o1 b  b  b  b  b  b  b  b  b  b 
b  b  b  b  b  b  b  b  b  b  o1 b  b  a3 a4 t3 t4 a3 a4 t3 t4 a3 a4 t3 t4 a3 a4 b  b  y1 b  b  b  b  b  b  b  b  b  b 
b  b  b  b  b  b  b  b  b  b  y1 b  b  t1 t2 a1 a2 t1 t2 a1 a2 t1 t2 a1 a2 t1 t2 b  b  o1 b  b  b  b  b  b  b  b  b  b 
b  b  b  b  b  b  b  b  b  b  o1 b  b  t3 t4 a3 a4 t3 t4 a3 a4 t3 t4 a3 a4 t3 t4 b  b  y1 b  b  b  b  b  b  b  b  b  b 
b  b  b  b  b  b  b  b  b  b  y1 b  b  b  b  b  b  b  b  g1 g2 b  b  b  b  b  b  b  b  o1 b  b  b  b  b  b  b  b  b  b         
b  b  b  b  b  b  b  b  b  b  o1 b  b  b  b  b  b  b  b  g2 g1  b  b  b  b  b  b  b  b  y1 b  b  b  b  b  b  b  b  b  b 
b  b  b  b  b  b  b  b  b  b  y1 b  b  b  b  b  b  b  b  b  b  b  b  b  b  b  b  b  b  o1 b  b  b  b  b  b  b  b  b  b 
b  b  b  b  b  b  b  b  b  b  o1 b  b  b  b  b  b  b  b  b  b  b  b  b  b  b  b  b  b  y1 b  b  b  b  b  b  b  b  b  b 
b  b  b  b  b  b  b  b  b  b  y1 o1 y1 o1 y1 o1 y1 o1 y1 b1 b1 o1 y1 o1 y1 o1 y1 o1 y1 o1  b  b  b  b  b  b  b  b  b  b 
b  b  b  b  b  b  b  b  b  b  b  b  b  b  b  b  b  b  b  b2 b2 b  b  b  b  b  b  b  b  b  b  b  b  b  b  b  b  b  b  b 
b  b  b  b  b  b  b  b  b  b  b  b  b  b  b  b  b  b  b  b2 b2 b  b  b  b  b  b  b  b  b  b  b  b  b  b  b  b  b  b  b 
b  b  b  b  b  b  b  b  b  b  b  b  b  b  b  b  b  b  b  b2 b2 b  b  b  b  b  b  b  b  b  b  b  b  b  b  b  b  b  b  b 
b  b  b  b  b  b  b  b  b  b  b  b  b  b  b  b  b  b  b  b2 b2 b  b  b  b  b  b  b  b  b  b  b  b  b  b  b  b  b  b  b                 